C 2, 11   ,255
NO      ./textures/eagle.xpm

R 100000000  1000000
WE  ./textures/purplestone.xpm

S ./textures/telet.xpm
EA ./textures/red.xpm
SO./textures/greystone.xpm
F                 100 ,100  ,  100  



        111111111111111111111111111111111111
111111111000000000000000011111
100000000000000000111000100001
110000100000000000000000001111
100001111111000000000000111111
111111100100000000000000000001
11110000000000110000000020001 
10000000000000000000000000001   
1100000000000011110000000000011     
10000000000111000000200000011
110000020000111000000000001111
110000000001111000000000000111
111111111101111111111111111
        1101
        1101   
        1101
        1101
        1101
         101
         101
         101
         101
       1110111
       1000001
       100E001
       1000001
       1000001
       1111111