C 28, 26 ,25
NO      ./textures/greystone.xpm

R 316894 64755
WE ./textures/greystone.xpm


S ./textures/greystone.xpm
EA ./textures/greystone.xpm
SO./textures/greystone.xpm
F                 25 ,25,25


        111111111111111111111111111111111111
111111111000000000000000011111
100000000000000000111000100001
110000100000000000000000001111
100001111111000000000000111111
111111100000000000000000000001
111100000000001100000000200011
10000000E00000000000000000001   
1100000000000011110000000000011     
10000000000111000000200000011
110000020000111000000000001111
110000000001111000000000000111
1111111111111111111111111111111

